8 8 8 8 8 8 8 8 8 8 8 8 8 8 8 8 8 8 8 8 8 8 8 8 8 8 8 8 8 8 8 8 8 8 8 8 8 8 8 8 
7  14 14 14 14 14 14 14 14 14 14 14 14 14 14 14 14 14 14 14 14 14 14 14 14 14 14 7  14 14 14 14 14 14 14 14 14 14 14 7
7  14 14 14 14 14 14 14 14 14 14 14 14 14 14 14 14 14 14 14 14 14 14 14 14 14 14 7  14 14 14 14 14 14 14 14 14 14 14 7
7  14 14 14 14 14 14 14 14 14 14 14 14 14 14 14 14 14 14 14 14 14 14 14 14 14 14 7  14 14 14 14 14 14 14 14 14 14 14 7
7  14 14 14 14 14 14 14 14 14 14 14 14 12 14 14 14 14 14 14 14 14 14 14 14 14 14 7  14 14 14 14 14 14 14 14 14 14 14 7
7  14 14 14 14 14 14 14 14 14 14 14 14 7  8  8  8  8  8  8  14 14 14 14 14 14 14 7  14 14 14 14 14 8  8  8  8  8  8  7
7  14 14 14 14 14 14 8  8  8  8  8  8  7  14 14 14 14 14 14 14 14 14 14 14 14 14 7  14 14 14 14 14 14 14 14 14 14 14 7
7  14 14 14 14 14 14 14 14 14 14 14 14 7  14 14 14 14 14 14 14 8  8  8  8  8  8  7  14 14 14 14 14 14 14 14 14 14 14 7
7  14 14 14 14 14 14 14 14 14 14 14 14 7  14 14 14 14 14 14 14 14 14 14 14 14 14 7  14 14 14 14 14 14 14 14 14 14 14 7
7  8  8  8  8  8  8  14 14 14 14 14 14 7  14 14 14 14 14 14 14 14 14 14 14 14 14 7  8  8  8  8  8  8  14 14 14 14 14 7
7  14 14 14 14 14 14 14 14 14 14 14 14 7  8  8  8  8  8  8  14 14 14 14 14 14 14 7  14 14 14 14 14 14 14 14 14 14 14 7
7  14 14 14 14 14 14 14 14 14 14 14 14 7  14 14 14 14 14 14 14 14 14 14 14 14 14 7  14 14 14 14 14 14 14 14 14 14 14 7
7  14 14 14 14 14 14 8  8  8  8  8  8  7  14 14 14 14 14 14 14 14 14 14 14 14 14 7  14 14 14 14 14 14 14 14 14 14 14 7
7  14 14 14 14 14 14 14 14 14 14 14 14 7  14 14 14 14 14 14 14 8  8  8  8  8  8  7  14 14 14 14 14 8  8  8  8  8  8  7
7  14 14 14 14 14 14 14 14 14 14 14 14 7  14 14 14 14 14 14 14 14 14 14 14 14 14 7  14 14 14 14 14 14 14 14 14 14 14 7
7  8  8  8  8  8  8  14 14 14 14 14 14 7  14 14 14 14 14 14 14 14 14 14 14 14 14 7  14 14 14 14 14 14 14 14 14 14 14 7
7  14 14 14 14 14 14 14 14 14 14 14 14 7  8  8  8  8  8  8  14 14 14 14 14 14 14 7  14 14 14 14 14 14 14 14 14 14 14 7
7  14 14 14 14 14 14 14 14 14 14 14 14 7  14 14 14 14 14 14 14 14 14 14 14 14 14 7  8  8  8  8  8  8  14 14 14 14 14 7
7  14 14 14 14 14 14 8  8  8  8  8  8  7  14 14 14 14 14 14 14 14 14 14 14 14 14 7  14 14 14 14 14 14 14 14 14 14 14 7
7  14 14 14 14 14 14 14 14 14 14 14 14 7  14 14 14 14 14 14 14 8  8  8  8  8  8  7  14 14 14 14 14 14 14 14 14 14 14 7
7  14 14 14 14 14 14 14 14 14 14 14 14 7  14 14 14 14 14 14 14 14 14 14 14 14 14 9  14 14 14 14 14 14 14 14 14 14 14 7
7  8  8  8  8  8  8  14 14 14 14 14 14 7  14 14 14 14 14 14 14 14 14 14 14 14 14 14 14 14 14 14 14 14 8  8  8  8  8  7
7  14 14 14 14 14 14 14 14 14 14 14 14 7  14 14 14 14 14 14 14 14 14 14 14 14 14 14 14 14 14 14 14 14 14 14 14 14 14 7
7  14 14 14 14 14 14 14 14 14 14 14 14 7  14 14 14 14 14 14 14 14 14 14 14 14 14 14 14 14 14 14 14 14 14 14 14 14 14 7
7 8 8 8 8 8 8 8 8 8 8 8 8 8 8 8 8 8 8 8 8 8 8 8 8 8 8 8 8 8 8 8 8 8 8 8 8 8 8 7

