8 8 8 8 8 8 8 8 8 8 8 8 8 8 8 8 8 8 8 8 8 8 8 8 8 8 8 8 8 8 8 8 8 8 8 8 8 8 8 8 
7  14 14 14 14 14 14 14 14 14 14 14 14 14 14 14 14 14 7  14 14 14 14 14 14 14 14 14 14 14 14 14 14 14 14 14 14 14 14 7
7  14 14 14 14 14 14 14 14 14 14 14 14 14 14 14 14 14 7  14 14 14 14 14 14 14 14 14 14 14 14 14 14 14 14 14 14 14 14 7
7  14 14 14 14 14 14 14 14 14 14 14 14 14 14 14 14 14 7  14 14 14 14 14 14 14 14 14 14 14 14 14 14 14 8  8  8  8  8  7
7  8  8  8  13 14 14 14 14 14 14 14 14 14 14 14 14 14 7  14 14 14 14 14 14 14 14 14 14 14 14 14 14 14 14 14 14 14 14 7
7  14 14 14 13 14 14 14 14 14 14 14 14 14 14 14 14 14 7  14 14 14 14 14 14 14 14 14 14 14 14 14 14 14 14 14 14 14 14 7
7  14 14 14 13 14 14 14 14 14 14 14 14 14 14 14 14 14 7  14 14 14 14 14 14 14 14 14 14 14 13 13 13 14 14 14 14 14 14 7
7  14 14 14 13 14 14 14 14 14 14 14 14 14 14 14 14 14 7  14 14 14 14 14 14 14 14 14 14 14 14 14 14 14 14 14 14 14 14 7
7  14 14 14 13 13 14 14 14 14 14 14 14 14 14 14 14 14 7  14 14 14 14 14 14 14 14 14 14 14 14 14 14 14 14 14 14 14 14 7
7  14 14 14 13 13 13 14 14 14 14 14 14 14 14 14 14 14 7  14 14 14 14 14 14 14 14 14 14 14 14 14 14 14 14 14 14 14 14 7
7  14 14 14 14 14 14 14 14 14 14 14 14 14 14 14 14 14 7  14 14 14 14 14 14 14 14 13 13 13 14 14 14 14 14 14 14 14 14 7
7  14 14 14 14 14 14 14 14 14 14 14 14 14 14 14 14 14 7  14 14 14 14 14 14 14 14 14 14 14 14 14 14 14 14 14 14 14 14 7
7  14 14 14 14 14 14 13 13 13 14 14 14 14 14 14 14 14 7  14 14 14 14 14 14 14 14 14 14 14 14 14 14 14 14 14 14 14 14 7
7  14 14 14 14 14 14 14 14 14 14 14 14 14 14 14 14 14 9  14 14 14 14 14 14 14 14 14 14 14 14 14 14 14 14 14 14 14 14 7
7  14 14 14 14 14 14 14 14 14 14 14 14 14 14 14 14 14 14 14 14 14 14 14 13 13 13 14 14 14 14 14 14 14 14 14 14 14 14 7
7  14 14 14 14 14 14 14 14 14 13 13 13 14 14 14 14 14 14 14 14 14 14 14 14 14 14 14 14 14 14 14 14 14 14 14 14 14 14 7
7  14 14 14 14 14 14 14 14 14 14 14 14 14 14 14 14 14 14 14 14 14 13 13 14 14 14 14 14 14 14 14 14 14 14 14 14 14 14 7
7  14 14 14 14 14 14 14 14 14 14 14 14 13 13 14 14 14 14 14 14 14 14 14 14 14 14 14 14 14 14 14 14 14 14 14 14 14 14 7
7  14 14 14 14 14 14 14 14 14 14 14 14 14 14 14 14 14 14 14 14 14 14 14 14 14 14 14 14 14 14 14 14 14 14 14 14 14 14 7
7  14 14 14 14 14 14 14 14 14 14 14 14 14 14 8  8  8  8  8  8  8  14 14 14 14 14 14 14 14 14 14 14 14 14 14 14 14 14 7
7  14 14 14 14 14 14 14 14 14 14 14 14 14 14 14 14 14 14 14 14 14 14 14 14 14 14 14 14 14 14 14 14 14 14 14 14 14 14 7
7  14 14 14 14 14 14 14 14 14 14 14 14 14 14 14 14 14 14 14 14 14 14 14 14 14 14 14 14 14 14 14 14 14 14 14 14 14 14 7
7  14 14 14 14 14 14 14 14 14 14 14 14 14 14 14 14 14 14 14 14 14 14 14 14 14 14 14 14 14 14 14 14 14 14 14 14 14 14 7
7  12 12 12 12 12 12 12 12 12 12 12 12 12 12 12 12 12 12 12 12 12 12 12 12 12 12 12 12 12 12 12 12 12 12 12 12 12 12 7
7 8 8 8 8 8 8 8 8 8 8 8 8 8 8 8 8 8 8 8 8 8 8 8 8 8 8 8 8 8 8 8 8 8 8 8 8 8 8 7

