8 8 8 8 8 8 8 8 8 8 8 8 8 8 8 8 8 8 8 8 8 8 8 8 8 8 8 8 8 8 8 8 8 8 8 8 8 8 8 8 
7  14 14 7  7  7  7  7  14 7  14 14 14 7  14 14 14 7  14 14 14 7  14 14 14 7  14 7  14 14 7  14 14 14 14 14 14 14 14 7
7  14 14 14 14 7  14 14 14 7  14 14 14 7  14 14 7  14 7  14 14 7  7  14 14 7  14 7  14 7  14 14 14 14 14 14 14 14 14 7
7  14 14 14 14 7  14 14 14 7  7  7  7  7  14 14 7  14 7  14 14 7  14 7  14 7  14 7  7  14 14 14 14 14 14 14 14 14 14 7
7  14 14 14 14 7  14 14 14 7  14 14 14 7  14 14 7  7  7  14 14 7  14 14 7  7  14 7  14 7  14 14 14 14 14 14 14 14 14 7
7  14 14 14 14 7  14 14 14 7  14 14 14 7  14 7  14 14 14 7  14 7  14 14 14 7  14 7  14 14 7  14 14 14 14 14 14 14 14 7
7  14 14 14 14 14 14 14 14 14 14 14 14 14 14 14 14 14 14 14 14 14 14 14 14 14 14 14 14 14 14 14 14 14 14 14 14 14 14 7
7  14 14 5  14 14 14 5  14 14 5  5  5  14 14 5  14 14 14 5  14 14 14 3  3  3  3  14 14 3  3  14 14 3  3  3  14 14 14 7
7  14 14 14 5  14 5  14 14 5  14 14 14 5  14 5  14 14 14 5  14 14 14 3  14 14 14 14 3  14 14 3  14 3  14 14 3  14 14 7
7  14 14 14 14 5  14 14 14 5  14 14 14 5  14 5  14 14 14 5  14 14 14 3  3  3  14 14 3  14 14 3  14 3  3  3  14 14 14 7
7  14 14 14 14 5  14 14 14 5  14 14 14 5  14 5  14 14 14 5  14 14 14 3  14 14 14 14 3  14 14 3  14 3  14 3  14 14 14 7
7  14 14 14 14 5  14 14 14 14 5  5  5  14 14 14 5  5  5  14 14 14 14 3  14 14 14 14 14 3  3  14 14 3  14 14 3  14 14 7
7  14 14 14 14 14 14 14 14 14 14 14 14 14 14 14 14 14 14 14 14 14 14 14 14 14 14 14 14 14 14 14 14 14 14 14 14 14 14 7
7  14 14 2  2  2  14 14 2  14 14 14 14 14 2  14 14 2  14 2  14 2  2  2  14 2  14 14 2  14 14 2  2  14 14 14 14 14 14 7
7  14 14 2  14 14 2  14 2  14 14 14 14 2  14 2  14 14 2  14 14 14 2  14 14 2  2  14 2  14 2  14 14 14 14 14 14 14 14 7
7  14 14 2  2  2  14 14 2  14 14 14 14 2  14 2  14 14 2  14 14 14 2  14 14 2  14 14 2  14 2  14 2  2  14 14 14 14 14 7
7  14 14 2  14 14 14 14 2  14 14 14 14 2  2  2  14 14 2  14 14 14 2  14 14 2  14 2  2  14 2  14 14 2  14 14 14 14 14 7
7  14 14 2  14 14 14 14 2  2  2  2  14 2  14 2  14 14 2  14 14 2  2  2  14 2  14 14 2  14 14 2  2  14 14 14 14 14 14 7
7  14 14 14 14 14 14 14 14 14 14 14 14 14 14 14 14 14 14 14 14 14 14 14 14 14 14 14 14 14 14 14 14 14 14 14 14 14 14 7
7  14 14 14 14 14 14 14 14 14 14 14 14 14 14 14 14 14 14 14 14 14 14 14 14 14 14 14 14 14 14 14 14 14 14 14 14 14 14 7
7  14 14 14 14 14 14 14 14 14 14 14 14 14 14 14 14 14 14 14 14 14 14 14 14 14 14 14 14 14 14 14 14 14 14 14 14 14 14 7
7  14 14 14 14 14 14 14 14 14 14 14 14 14 14 14 14 14 14 14 14 14 14 14 14 14 14 14 14 14 14 14 14 14 14 14 14 14 14 7
7  14 14 14 14 14 14 14 14 14 14 14 14 14 14 14 14 14 14 14 14 14 14 14 14 14 14 14 14 14 14 14 14 14 14 14 14 14 14 7
7  14 14 14 14 14 14 14 14 14 14 14 14 14 14 14 14 14 14 14 14 14 14 14 14 14 14 14 14 14 14 14 14 14 14 14 14 14 14 7
7 8 8 8 8 8 8 8 8 8 8 8 8 8 8 8 8 8 8 8 8 8 8 8 8 8 8 8 8 8 8 8 8 8 8 8 8 8 8 7

